-27
30
-25
30
0000000000000000000000000000000000000000000000000000000000
0000000000000000000000000000000000000000000000000000000000
0000000000000000000000000000000000000000000000000000000000
0000000000000000000000000000000000000000000000000000000000
0000000000000000000000000000000000000000000000000000000000
0000000000000000000000000000000000000000000000000000000000
0000000000000000000000000000000000000000000000000000000000
0000000000000000000000000000000000000000000000000000000000
0000000000000000000000000000000000000000000000000000000000
0000000000000000000000000000000000000000000000000000000000
0000000000000000000000000000000000000000000000000000000000
0000000000000000000000000000000000000000000000000000000000
0000000000000000000000000000000000000000000000000000000000
0000000000000000000000000000000000000000000000000000000000
0000000000000000000000000000000000000000000000000000000000
0000111111111111111111111111111111111111111111111111100000
0000111111111111111111111111111111111111111111111111100000
0000111111111111111111111111111111111111111111111111100000
0000111110000000000000000000000000000000000000000111100000
0000111110111111111111111111111111111111111111110111100000
0000111110100000001000111110000000000000000000010111100000
0000111110111111001000110110011111000000111111110111100000
0000111110110001001000100001011111111000100000110111100000
0000111110110001001000100000010000001000100000110111100000
0000111110111111101000100001010000001000100000110111100000
0000111110100000001111100000010000001000100011110111100000
0000111110100000000000000001010001111000100010010111100000
0000111110100000000000000000010001000000111110010111100000
0000111110110001111111110000011111000001111110010111100000
0000111110100000000000010000000000000000000010010111100000
0000111110100000000000010000000000000000000000010111100000
0000111110100000000000010000000000000000000000010111100000
0000111110100000000000010000000000000000000000010111100000
0000111110100000000000011111110001111111111100010111100000
0000111110100001000000000000000000000001000100010111100000
0000111110100000000000000000000000000001000100010111100000
0000111110100000000000000000000000000001000100010111100000
0000111110100001000000000000000000000001000100010111100000
0000111111100000000000000000000000000001000100010111100000
0000111111100000000000000000111110000001111100010111100000
0000111111100001000000000000111110000001101100010111100000
0000111111100000000000000000111110000000000000010001000000
0000111111100000000000010000111110001000000000010001000000
0000111110100111111111110000111110000000000000010001000000
0000111110100100000000010000111110000000000000010001000000
0000111110100100000000010000000000000000010010000001000000
0000111110100100000000010000000000000000000000000001000000
0000111110100111111100010000000000000000010010000001000000
0000111110100000000100010000000000000000000000101101000000
0000111110100000000111110011100010000000000000000001000000
0000111110111111111111111111100011111111111111111111000000
0000111110000000000000000000000000000000000000000000000000
0000111111111111111111111111111111111111111111111111100000
0000111111111111111111111111111111111111111111111111100000
0000111111111111111111111111111111111111111111111111100000
0000111111111111111111111111111111111111111111111111100000
